111111111111111111111
1P0C000000000C00001E1
100000000011111110001
1000000000111111C0001
100000000011111110001
100000000011111100001
100000000011111100001
100000000011111100001
100000000011111100001
100000000011111100001
100000000011111100001
100000000011111100001
100000000011111100001
100000000011111100001
111111111111111111111
